001	181
002	152	22	180	29	108	144	80	116	15	37	94	130	87	101	109	51	44	145	166	73	8	65	123	72	159	36	137	1	173	58
003	116	159	180	173	51	8	108	144	15	152	44	22	94	87	65	137	166	80	1	58	101	37	130	72	36	109	123	73	145	29
004	179	66	165	146	88	7	52	129	2	115	35	160	57	71	38	110	43	102	93	143	74	16	30	107	79	21	174	151	124	138
005	89	96	147	61	68	118	132	169	82	25	97	46	75	32	133	39	10	17	24	176	111	3	104	154	140	53	125	161	60	168
006	112	18	117	167	67	175	31	170	126	103	59	131	23	139	98	90	4	9	95	81	54	26	148	45	76	162	62	40	134	153
007	128	85	34	135	92	48	84	77	164	20	49	12	157	142	13	5	41	171	99	178	70	149	63	56	156	27	106	121	113	120
008	33	78	11	69	47	172	14	163	150	50	55	122	42	119	141	91	114	158	136	155	28	19	64	6	100	127	86	177	105	83
